20,20
22202222222222222222
01000222222222000000
20000000000000003002
22002222222222220222
22002222222222220222
22002222222222220222
22002222222222220222
22022222222222220222
22002222222222220222
22322222222222220222
22022222222222220222
22022000000000000222
22022222222222200042
20022222220002222222
20000000000000000002
20022200000002220002
22022200000002420002
22022220002000020002
22000020002200000002
22022222222222222222
